{
  "name": "level_0",
  "rect_x": 0.01,
  "rect_y": 0.01,
  "rect_w": 0.98,
  "rect_h": 0.600,
  "total_gap_x": 0.03,
  "total_gap_y": 0.1,
  "health_rows":
  [
    [6,6,6,6,0,1,1,1,1,0,6,6,6,6],
    [1,1,1,1,1,1,1,1,1,1,1,1,1,1],
    [1,1,0,1,1,0,3,3,3,3,0,1,1,0,1,1],
    [3,3,3,3,0,1,1,1,1,0,3,3,3,3],
    [1,1,1,1,1,1,1,1,1,1,1,1,1,1],
    [1,1,0,1,1,0,4,4,4,4,0,1,1,0,1,1],
    [6,6,6,6,0,1,1,1,1,0,6,6,6,6],
    [1,1,1,1,1,1,1,1,1,1,1,1,1,1],
    [1,1,0,1,1,0,3,3,3,3,0,1,1,0,1,1],
    [3,3,3,3,0,1,1,1,1,0,3,3,3,3],
    [1,1,1,1,1,1,1,1,1,1,1,1,1,1],
    [1,1,0,1,1,0,4,4,4,4,0,1,1,0,1,1]
  ],
  "bonus_rows":
  [
    [1,1,1,1,0,1,1,1,1,0,1,1,1,1],
    [1,2,2,1,1,1,1,1,1,1,4,1,2,1],
    [1,1,0,1,1,0,1,1,1,1,0,1,1,0,2,1],
    [1,1,3,1,0,1,1,1,1,0,4,1,2,1],
    [1,2,1,1,4,1,1,1,4,1,1,1,1,1],
    [1,1,0,1,4,0,1,1,1,1,0,1,3,0,1,1],
    [1,3,1,1,0,1,1,4,1,0,1,2,1,1],
    [1,1,1,3,1,1,2,1,1,1,3,1,1,1],
    [2,1,0,1,1,0,1,2,1,1,0,1,1,0,1,2],
    [1,1,1,1,0,1,1,1,1,0,1,1,2,1],
    [1,3,1,1,3,1,1,1,4,1,1,1,1,1],
    [1,1,0,2,1,0,1,1,1,1,0,3,1,0,1,1]
  ],

  "colors":
  {
    "1": "#606C38",
    "3": "#283618",
    "4": "#FEFAE0",
    "6": "#DDA15E"
  },

  "edge_size": 0,

  "background_color": "#BC6C25",
  "paddle_color": "#FEFAE0",
  "paddle_edge_size": 0

}