{
  "name": "level_0",
  "rect_x": 0.05,
  "rect_y": 0.1,
  "rect_w": 0.9,
  "rect_h": 0.65,
  "total_gap_x": 0.0,
  "total_gap_y": 0.0,
  "health_rows":
  [

    [3,4,6],
    [0,0,4,0,0,4,0,0,4,0,0],
    [4,4,4,4,4,4,4,4,4,4,4,4,4,4,4],

    [3,4,6,6,6,4,3],
    [3,3,3,0,0,0,0,3,3,3],
    [4,4,4,4,4,4,4,4,4,4,4,4,4,4,4],

    [3,4,6],
    [0,0,4,0,0,4,0,0,4,0,0],
    [0,6,0,6,0,6,0,6,0],

    [4,4,4,4,4,4,4,4,4,4,4,4,4,4,4],
    [3,3,3,0,0,0,0,3,3,3],
    [4,4,6,4,4,4,6,4,4],
    [3,4,6],
    [4,4,4,4,4,4,4,4,4,4,4,4,4,4,4]
  ],
 "bonus_rows":
  [
    [2,3,3],
    [0,0,1,0,0,2,0,0,3,0,0],
    [3,2,1,2,3,3,1,2,3,3,1,2,3,3,1],
    [3,3,2],
    [0,0,2,0,0,2,0,0,3,0,0],
    [3,2,2,2,3,2,1,2,3,2,1,2,3,3,1],

    [3,3,3],
    [0,0,1,0,0,1,0,0,1,0,0],
    [0,1,0,1,0,1,0,1,0],

    [2,2,1,2,3,3,1,2,3,4,1,2,3,3,1],
    [2,2,2,0,0,0,0,2,2,2],
    [2,2,4,2,2,2,4,2,2],

    [3,1,3],
    [1,1,1,1,1,1,1,1,1,1,1,1,1,1,1]
  ],

  "colors":
  {
    "3": "#C81D25",
    "4": "#087E8B",
    "6": "#0B3954"
  },

  "edge_size": 0,
  "background_color": "#BFD7EA",
  "ball_color": "#C81D25",
  "paddle_color": "#C81D25",
  "paddle_edge_size": 0


}