{
  "name": "My New Game",
  "rect_x": 0.1,
  "rect_y": 0.1,
  "rect_w": 0.8,
  "rect_h": 0.7,
  "total_gap_x": 0.05,
  "total_gap_y": 0.05,
  "health_rows":
  [

    [10,0,7,7,7,7,7,7,7,7,7,0,10],
    [10,0,1,0,0,0,0,0,1,0,10],
    [10,0,7,0,0,4,4,4,0,0,0,0,7,0,10],
    [10,0,7,0,3,6,6,0,0,0,7,0,10],
    [10,0,7,0,6,3,6,0,7,0,10],
    [10,0,7,0,0,6,6,0,0,0,0,0,0,7,0,10],
    [10,0,1,0,4,4,4,4,0,0,7,0,10],
    [10,0,0,7,0,0,0,0,0,7,0,0,10],
    [10,0,0,0,7,7,7,7,7,7,7,7,7,7,7,7,0,0,0,10]

  ],

 "bonus_rows":
  [
    [4,0,2,3,2,3,2,3,2,3,2,0,4],
    [2,0,1,0,0,0,0,0,1,0,2],
    [4,0,1,0,0,1,1,1,0,0,0,0,1,0,4],
    [2,0,1,0,1,1,1,0,0,0,1,0,2],
    [4,0,1,0,1,1,1,0,1,0,4],
    [2,0,1,0,0,1,1,0,0,0,0,0,0,1,0,2],
    [4,0,1,0,1,1,1,1,0,0,1,0,4],
    [2,0,0,1,0,0,0,0,0,1,0,0,2],
    [4,0,0,0,3,2,3,2,3,2,3,2,2,3,3,2,0,0,0,4]
  ],

  "colors":
  {
    "1": "#EE9B00",
    "2": "#CA6702",
    "3": "#BB3E03",
    "4": "#AE2012",
    "5": "#9B2226",
    "6": "#001219",
    "7": "#005F73",
    "10": "#0A9396"
  },

  "edge_size": 0,
  "background_color": "#94D2BD",
  "ball_color": "#E9D8A6",
  "paddle_color": "#E9D8A6",
  "paddle_edge_size": 20


}
